
R 1200 800
NO ./textures/bluestone.xpm
SO ./textures/colorstone.xpm

WE ./textures/greystone.xpm

EA ./textures/purplestone.xpm
S ./textures/pillar.xpm
F 0,153,76
C 102,178,255

111111111111111111
100000000000000001
100000000000000001
100000000000000001
100000000000000001
100000000000000001
100000000000000001
100000000000000001
100000000000000001
100000000000000001
111111111101111111
        1100111111111111111111111
        1000000000110000000000001
        1011000001110000002000001
        10010000E000 000000000001
111111111011000001110000000000001
100000000011000001110111111111111
11110111111111001100000010001
11110111111111011101010010001
11000000110101011100000010001
10002000000000000000000010001
10000000000000001101010000001
1100000111010101111101111000111
11110111 1110101 101111010001
11111111 1111111 111111111111