
R 1200 800
NO ./textures/wood.xpm
SO ./textures/mossy.xpm

WE ./textures/colorstone.xpm

EA ./textures/redbrick.xpm
S ./textures/barrel.xpm
F 0,153,76
C 102,178,255

1111111111111111110000000000000001
100000000000000001
100200020000000201
100000000000000001
100000020000200001
100002000000000001
100000000000000001
100000000000200001
100020000000000001
111111111101111111
        1100111111111111111111110
        1000000000110000000000001
        1011000001110000002000001
        100100000000 000200000001
111111111011000001110000000000001
100000000011000001110111111111110
11110111111111001100000010001
11110111111111011101010010001
11000000110101011100000010001
10002000000000000000000010001
10000000000000001101010000001
1100000111010101111101111000111
11110111 1110101 1011110100N1
11111111 1111111 111111111110