R 1080 720
NO ./textures/bluestone.xpm
SO ./textures/colorstone.xpm
WE ./textures/greystone.xpm
EA ./textures/purplestone.xpm
S ./textures/pillar.xpm
F 4,5,6
C 255,255,255

11111111111111 1111111111
10000000000001 1000000001
101100000111000000W002001
100100000000000000000000111111111
111111111011000001110000000000001
100000000011000001110111111111111
11110111111111011100000010001
11110111111111011101010010201
11000000110101011100000000001
10002000000000001100000010001
10000000000000001101010010001
11000001110101011101011110001
11110111111101011101111000001
11111111111111111111111111111
