R 1000 1000
NO ./textures/bluestone.xpm
SO ./textures/colorstone.xpm
WE ./textures/greystone.xpm
EA ./textures/purplestone.xpm
S ./textures/pillar.xpm
F 220,100,0
C 225,30,0

11111
1S001
10001
11111
