R 640 480
NO ./textures/bluestone.xpm
SO ./textures/colorstone.xpm
WE ./textures/greystone.xpm
EA ./textures/purplestone.xpm
S ./textures/pillar.xpm

F 255,255,255
C 0,0,0

11111111111111111111111111111
10000000001100000000000000001
10110000011100000020000010001
10110000000000000000000010001
10110000011100000020000000001
10000000001100000111011111111
11110111111111011100001
111101111111110111010111  111
110000001101010111000001  101
10000000000000001100000111101
10020000000000001101000000001
11000000110101011111011110N01
11110111111101000000011110001
11110000001111111111111111111
11111111111111111111111111111
